WWWWWWWWWWWWWWWWWWWW
WS      SSSSSS     W
WS  D S R S S SS   W
WS S    S M S S S  W
WS S  SS S S S S S W
WS  S  S SS  S   S W
WS  P S R  S   SS  W
WS    S S SSS D S  W
WS  SS    S S   S  W
WS S   S S S S   SXW
WWWWWWWWWWWWWWWWWWWW
